................
...<<>>>>>>>>...
................
...!........$...
................
................
.w............r.
